CHINESE CONTAMINATION REPORT
================================================================================

Total Lengxuan words: 2715
Exact Chinese matches: 0
Single-syllable matches: 280

SINGLE-SYLLABLE MATCHES (Review):
--------------------------------------------------------------------------------
ba-niu                    → odwaga                                   (root: ba)
ba-wang                   → tradycja                                 (root: ba)
ba-xue                    → klon                                     (root: ba)
ba-za                     → przysięga                                (root: ba)
bai-nang                  → waga                                     (root: bai)
bai-pai                   → ścierka                                  (root: bai)
bai-wan                   → milion                                   (root: bai)
bai-xiong                 → siostra cioteczna (starsza)              (root: bai)
bai-zou                   → przysięgły brat                          (root: bai)
bei-de                    → kichać                                   (root: bei)
bei-den                   → wąskohoryzontalny                        (root: bei)
bei-guan                  → porzucić                                 (root: bei)
bei-hui                   → szeroki                                  (root: bei)
bei-xi                    → cegła                                    (root: bei)
bei-xiang                 → pierścień                                (root: bei)
bei-zei                   → lina                                     (root: bei)
bei-zhao                  → patogen wiatru                           (root: bei)
chi-cong                  → narracja, opowiadanie                    (root: chi)
chi-fa-duo                → różnorodność                             (root: chi)
chi-guang                 → przełożony                               (root: chi)
chi-jing-shui             → dzikie zwierzęta                         (root: chi)
chi-mie                   → goleń                                    (root: chi)
chi-qia-zui               → filozof                                  (root: chi)
chi-shang                 → jabłko                                   (root: chi)
chi-she                   → natychmiastowy                           (root: chi)
da-cheng                  → smażyć do sucha                          (root: da)
da-dui                    → smażyć na dużym ogniu                    (root: da)
da-fei                    → zakonnica                                (root: da)
da-ri                     → szybko smażyć                            (root: da)
da-shuo                   → przytulać                                (root: da)
da-sun                    → pokój medytacji                          (root: da)
da-tuo-rao                → sala koncertowa                          (root: da)
da-wang                   → smażony (stir-fry)                       (root: da)
da-xun                    → balustrada                               (root: da)
da-yang                   → kora cynamonu                            (root: da)
da-zhu                    → doświadczenie                            (root: da)
da-zhuan                  → smażyć warzywa                           (root: da)
da-zou                    → smażony makaron                          (root: da)
di-cu                     → chodzić, iść pieszo                      (root: di)
di-dao                    → kogut                                    (root: di)
di-fan                    → chwalić                                  (root: di)
di-zao                    → nadzieja                                 (root: di)
dong-chang                → z tyłu                                   (root: dong)
dong-er                   → fasola, bob                              (root: dong)
dong-mie                  → przewrócić                               (root: dong)
dong-nong                 → podekscytowany                           (root: dong)
dong-shuan                → obojętny, apatyczny                      (root: dong)
dong-tang                 → język                                    (root: dong)
dong-zei                  → sławny                                   (root: dong)
dong-zuo                  → problem                                  (root: dong)
er-ba                     → strata                                   (root: er)
er-da                     → lecieć                                   (root: er)
er-fou                    → ilość                                    (root: er)
er-nie                    → jeleń                                    (root: er)
er-ye                     → kolendra                                 (root: er)
feng-biao                 → początek jesieni                         (root: feng)
feng-pian                 → arhat                                    (root: feng)
feng-su                   → smak                                     (root: feng)
feng-zheng                → gratulacje                               (root: feng)
feng-zhuan                → palić kadzidło                           (root: feng)
gao-beng                  → drugorzędny                              (root: gao)
gao-de                    → karp                                     (root: gao)
gao-feng                  → przyjmować (gości)                       (root: gao)
gao-ha                    → razem                                    (root: gao)
gao-jiao                  → kamień do rozcierania tuszu              (root: gao)
gao-luo                   → niefortunny                              (root: gao)
gao-niang                 → król                                     (root: gao)
gao-qie                   → smalec                                   (root: gao)
gao-ta                    → oolong                                   (root: gao)
ge-chuan                  → nieprzytomny                             (root: ge)
ge-ga                     → samolot                                  (root: ge)
ge-lao                    → konserwatywny                            (root: ge)
ge-lei                    → obracać                                  (root: ge)
ge-nuo                    → zgadzać się                              (root: ge)
ge-shui                   → rumak                                    (root: ge)
ge-sun                    → przydzielać                              (root: ge)
ge-tan                    → wyrzucić                                 (root: ge)
ge-xiu                    → wspominać                                (root: ge)
hao-chuan                 → terapia manipulacyjna                    (root: hao)
hao-gong                  → niskiej jakości                          (root: hao)
hao-pu                    → podwładny                                (root: hao)
hao-quan                  → demon, potwór                            (root: hao)
he-ceng                   → samantabhadra (bodhisattwa)              (root: he)
he-fou                    → tekstura                                 (root: he)
he-nai                    → małpa                                    (root: he)
he-nue                    → małe dziecko                             (root: he)
he-peng                   → kampania wojenna                         (root: he)
he-sang                   → przed południem                          (root: he)
he-she                    → świątynia taoistyczna                    (root: he)
he-shuang                 → pasmo górskie                            (root: he)
he-zhuan                  → ciocia (siostra ojca)                    (root: he)
hei-bie                   → naprawiać                                (root: hei)
hei-pao                   → duma (pozytywna)                         (root: hei)
hei-zhan                  → krzesło                                  (root: hei)
hong-la                   → pozioma kreska                           (root: hong)
hong-zen                  → równowaga                                (root: hong)
huo-da                    → trafić                                   (root: huo)
huo-hong                  → następca tronu                           (root: huo)
huo-jiong                 → oszukiwać                                (root: huo)
huo-pie                   → uczucie (dotyk)                          (root: huo)
jie-chuo                  → wasza Wysokość                           (root: jie)
jie-fo                    → ubierać się                              (root: jie)
jie-kui                   → zadowolenie, satysfakcja                 (root: jie)
jie-lian                  → technika miecza                          (root: jie)
jie-na                    → haczyk                                   (root: jie)
jie-wu                    → przekazywać                              (root: jie)
jie-zhi                   → pod wiatr                                (root: jie)
jie-zhui                  → skarpetki                                (root: jie)
jiu-kuang                 → przypominać sobie                        (root: jiu)
jiu-long                  → smaczny (umami)                          (root: jiu)
jiu-shou                  → rezerwować, przygotować z wyprzedzeniem  (root: jiu)
jiu-zheng                 → społeczeństwo                            (root: jiu)
kan-duo                   → list, korespondencja                     (root: kan)
kan-mou                   → żal, skrucha                             (root: kan)
kan-na-pi                 → niestabilny                              (root: kan)
kan-xuan                  → spódnica                                 (root: kan)
kan-zhuo                  → strączki fasolowe                        (root: kan)
kan-zou-song              → ośmiokątny                               (root: kan)
lai-kei                   → dokument                                 (root: lai)
lai-lun                   → konwertować                              (root: lai)
lai-zuo-ti                → jedność nieba i człowieka                (root: lai)
lan-ba                    → podnieść, wziąć                          (root: lan)
lan-deng                  → prawa                                    (root: lan)
lan-mai-hu                → oszczędność energii                      (root: lan)
lan-re                    → magazyn                                  (root: lan)
liu-bi                    → z wiatrem                                (root: liu)
liu-gao                   → grzybek srebrny                          (root: liu)
liu-hu                    → powodzenia                               (root: liu)
liu-kao                   → banknot srebrny                          (root: liu)
liu-reng-chen             → granit                                   (root: liu)
liu-xia                   → chronić                                  (root: liu)
liu-ye                    → srebrny                                  (root: liu)
liu-zhong                 → sadzonka                                 (root: liu)
liu-zu                    → latarnia                                 (root: liu)
lu-bao                    → wyrafinowany                             (root: lu)
lu-bing                   → szyk bojowy                              (root: lu)
lu-nue                    → miękkie drewno                           (root: lu)
lu-qing                   → odmrożenie                               (root: lu)
lu-rui                    → ofiara (przedmiot)                       (root: lu)
lu-xi                     → sześćdziesiąt                            (root: lu)
ma                        → uczyć                                    (root: ma)
ma-an                     → nauka                                    (root: ma)
ma-bai                    → nauka Xiao-Diu                           (root: ma)
ma-cha                    → uczeń, adept                             (root: ma)
ma-chao                   → sala Buddy                               (root: ma)
ma-chuo                   → wielki nauczyciel (tytuł)                (root: ma)
ma-dou                    → nauka Fen-Mai                            (root: ma)
ma-ju                     → nauczyć się                              (root: ma)
ma-kuang                  → zewnętrzny uczeń                         (root: ma)
ma-lu                     → uczyć się                                (root: ma)
ma-nan                    → wewnętrzny uczeń                         (root: ma)
ma-nian                   → nauczyciel pięściarstwa                  (root: ma)
ma-ren                    → nauczyciel                               (root: ma)
ma-rong                   → uczeń osobisty                           (root: ma)
ma-sen                    → współuczeń (ogólnie)                     (root: ma)
ma-ti                     → z przodu                                 (root: ma)
ma-xie                    → starszy współuczeń (mężczyzna)           (root: ma)
ma-zhao                   → zrealizować                              (root: ma)
ma-zuan                   → nauka walki, sztuki                      (root: ma)
mei                       → czarny                                   (root: mei)
mei-biao                  → wstrzymywać                              (root: mei)
mei-bu                    → kruk czarny                              (root: mei)
mei-chi                   → środek, umiarkowanie                     (root: mei)
mei-da                    → czarny wojownik (kierunek północ), żółw i wąż (root: mei)
mei-gen                   → udo                                      (root: mei)
mei-kuan-xu               → styl podobny do Muay                     (root: mei)
mei-liang                 → jesień                                   (root: mei)
mei-pei                   → niedźwiedź czarny                        (root: mei)
mei-ta                    → syn Niebios (tytuł władcy)               (root: mei)
mei-wu                    → zemścić się                              (root: mei)
mei-ya                    → drogą lądową                             (root: mei)
qi-chuan                  → piwonia biała                            (root: qi)
qi-kai                    → usłyszeć                                 (root: qi)
qi-kuai                   → koniec upału                             (root: qi)
qi-niao                   → łowy                                     (root: qi)
qi-ning                   → kroić w paski                            (root: qi)
qi-pang                   → ulewny deszcz                            (root: qi)
qi-xi                     → rozkaz wojskowy (tabliczka)              (root: qi)
qi-xiao                   → wojsko (dosł. żołnierze i konie)         (root: qi)
qu-ben                    → deszcz zbóż                              (root: qu)
qu-ci                     → stabilność                               (root: qu)
qu-pao                    → szeregować                               (root: qu)
qu-san                    → miłość romantyczna                       (root: qu)
qu-xiao                   → uczestniczyć                             (root: qu)
qu-yang                   → kieliszek do wina                        (root: qu)
qu-yuan                   → ciekawy, interesujący                    (root: qu)
qu-yue                    → zawias                                   (root: qu)
qu-zhan                   → teatr                                    (root: qu)
qu-zhen                   → klimat                                   (root: qu)
qu-zhou                   → miłość (rzeczownik)                      (root: qu)
ren-ban                   → Płuco (organ TCM)                        (root: ren)
ren-da-chun               → sklep z czapkami                         (root: ren)
ren-liang                 → prowadzenie i rozciąganie                (root: ren)
ren-nong                  → urodziny                                 (root: ren)
ren-re                    → nad ranem                                (root: ren)
ren-shui                  → dawno temu                               (root: ren)
san-chuo                  → lukrecja                                 (root: san)
san-wang                  → pod Niebem, świat                        (root: san)
san-wo                    → ogród wewnętrzny                         (root: san)
san-zei                   → rozbierać się                            (root: san)
shan-cuan                 → zewnątrz                                 (root: shan)
shan-yun                  → przerywać                                (root: shan)
shan-zui-rong             → wielki Turniej Dziedzictwa Fengzhana     (root: shan)
shan-zuo                  → akapit                                   (root: shan)
shi-ben                   → w ogóle                                  (root: shi)
shi-dong                  → ying-Gang                                (root: shi)
shi-hai                   → wielbłąd                                 (root: shi)
shi-hou                   → pierwotna pustka                         (root: shi)
shi-huai                  → zrozumieć                                (root: shi)
shi-lao                   → regał na książki                         (root: shi)
shi-ren                   → historyk                                 (root: shi)
shi-xian-zha              → sześciokątny                             (root: shi)
shi-zi                    → fasola mung                              (root: shi)
shuo-lin                  → błąd                                     (root: shuo)
shuo-sou                  → placek, naleśnik                         (root: shuo)
shuo-yin                  → zamieć                                   (root: shuo)
shuo-zhuo                 → suknia wieczorowa                        (root: shuo)
si-ge                     → suchy                                    (root: si)
si-hou                    → szczyt góry                              (root: si)
si-mo                     → chusta, szal                             (root: si)
si-mu                     → czcigodny (dla władców/bóstw)            (root: si)
si-sen                    → czapla szara                             (root: si)
si-zhai                   → kompletny, cały                          (root: si)
tian-cun                  → prawdopodobnie                           (root: tian)
tian-dai                  → pomarańczowy                             (root: tian)
tian-gua                  → niedobór Kao-Fa                          (root: tian)
tian-guai                 → grzywna                                  (root: tian)
tian-ha                   → zdecydowanie                             (root: tian)
tian-he                   → kao-Fa wątroby                           (root: tian)
tian-hen                  → wróżbiarstwo                             (root: tian)
tian-jian                 → guzheng (cytra)                          (root: tian)
tian-jie                  → rozciągać, przedłużać                    (root: tian)
tian-pin                  → chłód                                    (root: tian)
tian-ruo                  → droga Niebios jest bez końca             (root: tian)
tian-xing                 → obiad                                    (root: tian)
wu-ding                   → wąwóz                                    (root: wu)
wu-gui                    → konsultować, omawiać                     (root: wu)
wu-hong                   → w pobliżu                                (root: wu)
wu-hun                    → poznać, rozpoznać                        (root: wu)
wu-jia                    → szef                                     (root: wu)
wu-nou                    → igiełkowaty                              (root: wu)
wu-nu                     → szczególny                               (root: wu)
wu-peng                   → kalendarz księżycowy                     (root: wu)
wu-que                    → mięsień                                  (root: wu)
wu-shou                   → lepiej                                   (root: wu)
wu-wei                    → karmić piersią                           (root: wu)
wu-xuan                   → armia                                    (root: wu)
xi-pai-lun                → lis używający tygrysiej siły (idiom)     (root: xi)
xi-song                   → pestka                                   (root: xi)
xi-suo                    → bransoletka                              (root: xi)
xin-duo                   → taoistyczny kapłan                       (root: xin)
xin-gei                   → poczta                                   (root: xin)
xin-heng                  → sztuka walki mieczem                     (root: xin)
xin-hou                   → stolarz, cieśla                          (root: xin)
xin-li                    → talent                                   (root: xin)
xin-pan                   → kruchy, delikatny                        (root: xin)
yi-fo                     → północny zachód                          (root: yi)
yi-hei-fan                → możliwość                                (root: yi)
yi-jue                    → król smoków                              (root: yi)
yi-ka                     → krab                                     (root: yi)
yi-ming                   → bambus                                   (root: yi)
yi-nen                    → współczesność                            (root: yi)
yi-peng                   → wierzyć                                  (root: yi)
yu-bin                    → jeszcze sui-qu                           (root: yu)
yu-fa                     → stawać się, zostawać                     (root: yu)
yu-ga                     → wysłannik                                (root: yu)
yu-hua                    → yu-hua (język)                           (root: yu)
yu-jun                    → wąski                                    (root: yu)
yu-kao                    → decydować                                (root: yu)
yu-wa-hun                 → poprzedni                                (root: yu)
zou-en                    → poddać się                               (root: zou)
zou-gui                   → krok, etap                               (root: zou)
zuo-chao                  → uszko Judasza                            (root: zuo)
zuo-deng                  → stołek                                   (root: zuo)
zuo-duo                   → longan                                   (root: zuo)
zuo-hu                    → kiwać głową                              (root: zuo)
zuo-huan                  → zatrzymać                                (root: zuo)
zuo-zen                   → uderzać pięścią                          (root: zuo)
zuo-zhou                  → intensywny (kolor)                       (root: zuo)
zuo-zhui                  → dziękować                                (root: zuo)
